First Class - Jack Harlow
As It Was - Harry Styles
Heat Waves - Glass Animals
Big Energy - Latto
Enemy - Imagine Dragons X JID
Stay - The Kid LAROI & Justin Bieber
Super Gremlin - Kodak Black
Woman - Doja Cat
Ghost - Justin Bieber
Thats What I Want - Lil Nas X
abcdefu - GAYLE
Bad Habits - Ed Sheeran
Right On - Lil Baby
In A Minute - Lil Baby
Shivers - Ed Sheeran
Cold Heart (PNAU Remix) - Elton John & Dua Lipa
Easy On Me - Adele
We Don't Talk About Bruno - Carolina Gaitan, Mauro Castillo, Adassa, Rhenzy Feliz, Diane Guerrero, Stephanie Beatriz & Encanto Cast
Industry Baby - Lil Nas X & Jack Harlow
Need To Know - Doja Cat
Levitating - Dua Lipa
'Til You Can't - Cody Johnson
Save Your Tears - The Weeknd & Ariana Grande
One Right Now - Post Malone & The Weeknd
Bam Bam - Camila Cabello Featuring Ed Sheeran
Hrs And Hrs - Muni Long
Never Say Never - Cole Swindell / Lainey Wilson
Good 4 U - Olivia Rodrigo
I Hate U - SZA
MAMIII - Becky G X Karol G
Doin' This - Luke Combs
AA - Walker Hayes
Sweetest Pie - Megan Thee Stallion & Dua Lipa
Fingers Crossed - Lauren Spencer Smith
Pushin P - Gunna & Future Featuring Young Thug
Wasted On You - Morgan Wallen
You Right - Doja Cat & The Weeknd
Fancy Like - Walker Hayes
What Happened To Virgil - Lil Durk Featuring Gunna
Nail Tech - Jack Harlow
Beers On Me - Dierks Bentley, BRELAND & HARDY
To The Moon! - JNR CHOI & Sam Tompkins
Light Switch - Charlie Puth
Boyfriend - Dove Cameron
Numb Little Bug - Em Beihold
Drunk (And I Don't Wanna Go Home) - Elle King & Miranda Lambert
Buy Dirt - Jordan Davis Featuring Luke Bryan
Sand In My Boots - Morgan Wallen
The Motto - Tiesto & Ava Max
She's All I Wanna Be - Tate McRae
Slow Down Summer - Thomas Rhett
When You're Gone - Shawn Mendes
Peru - Fireboy DML & Ed Sheeran
Handsomer - Russ Featuring Ktlyn
23 - Sam Hunt
Surface Pressure - Jessica Darrow
Circles Around This Town - Maren Morris
Broadway Girls - Lil Durk Featuring Morgan Wallen
No Love - Summer Walker & SZA
Freaky Deaky - Tyga X Doja Cat
Ahhh Ha - Lil Durk
London - BIA Featuring J. Cole
Heart On Fire - Eric Church
In My Head - Lil Tjay
Never Wanted To Be That Girl - Carly Pearce & Ashley McBryde
Me Or Sum - Nardo Wick, Lil Baby & Future
Flower Shops - ERNEST Featuring Morgan Wallen
If I Was A Cowboy - Miranda Lambert
Soy El Unico - Yahritza y Su Esencia
Do We Have A Problem? - Nicki Minaj X Lil Baby
City Of Gods - Fivio Foreign, Kanye West & Alicia Keys
Nobody Like U - 4*TOWN (From Disney And Pixar's Turning Red)
Trouble With A Heartbreak - Jason Aldean
Envolver - Anitta
Psychofreak - Camila Cabello Featuring WILLOW
Give Heaven Some Hell - HARDY
Rumors - Gucci Mane Featuring Lil Durk
The Family Madrigal - Stephanie Beatriz, Olga Merediz & Encanto Cast
Thump Shit - 42 Dugg & EST Gee
Take My Name - Parmalee
Treat Me - Chloe
Get Into It (Yuh) - Doja Cat
To Be Loved By You - Parker McCollum
Come Back As A Country Boy - Blake Shelton
Complete Mess - 5 Seconds Of Summer
I Love You So - The Walters
Banking On Me - Gunna
Thinking With My Dick - Kevin Gates Featuring Juicy J
Damn Strait - Scotty McCreery
She Likes It - Russell Dickerson & Jake Scott
P Power - Gunna Featuring Drake
Pressure - Ari Lennox
Dos Oruguitas - Sebastian Yatra
Bones - Imagine Dragons
Blick Blick! - Coi Leray & Nicki Minaj
Over - Lucky Daye
Neck & Wrist - Pusha T Featuring JAY-Z & Pharrell Williams
Desesperados - Rauw Alejandro & Chencho Corleone
X Ultima Vez - Daddy Yankee & Bad Bunny
Praise The Lord - BRELAND Featuring Thomas Rhett
